..##..##..##..##..##..##.........
.................................
..##..##..##..##..##..##.........
..##..##..##..##..##..##.....~...
..##..##..##..##..##..##.........
..##..##..##..##..##..##.........
..##..##..##%%##..##..##.........
..##..##..##%%##..##..##.........
..##..##..##..##..##..##.....@...
..##..##..........##..##.........
..##..##..........##..##.........
..........##..##.................
..........##..##.............@...
##..####..........####..##.......
%%..####..........####..%%.......
..........##..##................~
..........######.................
..##..##..######..##..##.....~...
..##..##..##..##..##..##.........
..##..##..##..##..##..##.........
..##..##..##..##..##..##.....~...
..##..##..........##..##.........
..##..##..........##..##.........