.#.............................#.
.#...##..##..##...##..##..##...#.
.#...##..##..##...##..##..##...#.
.#...##..##..##...##..##..##...#.
.#...##..##..##@.@##..##..##...#.
.#...##..##..##@.@##..##..##...#.
.#...##..##..##...##..##..##...#.
.#...##..##...........##..##...#.
.#...##..##...........##..##...#.
.#...........##...##...........#.
.#...........##...##...........#.
.#..#..####...........####..#..#.
.#..@..####...........####..@..#.
.#...........##...##...........#.
.#...##..##..###.###..##..##...#.
.#...##..##..##...##..##..##...#.
.#...##..##..##...##..##..##...#.
.#...##..##..##...##..##..##...#.
.#...##..##...........##..##...#.
.#...##..##...........##..##...#.
.#...##..##...##.##...##..##...#.
.#............#...#............#.
.#............#...#............#.