.#.............................#.
.#...##..##..##...##..##..##...#.
.#...##..##..##...##..##..##...#.
.#...##..##..##...##..##..##...#.
.#...##..##..##@.@##..##..##...#.
.#...##..##..##@.@##..##..##...#.
.#...##..##..##...##..##..##...#.
.#...##..##..%%.......##..##...#.
.#...##..##..%%.......##..##...#.
.#...........##...##...........#.
.#...........##...##...........#.
.#..#..%%%%...........####..#..#.
.#..@..%%%%...........####..@..#.
.#...........%%%%%%%...........#.
.#...##..##..###.###..##..##...#.
.#...##..##..##...##..##..##...#.
.#...##..##..##...##..##..##...#.
.#...##..##..##...##..##..##...#.
.#...##..##...........##..##...#.
.#...##..##...........##..##...#.
.#...##..##...##.##...##..##...#.
.#............#...#............#.
.#............#...#............#.
